11111111111111111111111111111111
1C000000000000000000000100010001
11111001000001000001000100010C01
1111001100100100C001000100000001
1110011100100101111100010C010001
11001111001001000001000000010001
1001111100100100C001000111110001
10C110010C10011111010E010C010P01
10000001111001C00001000000010001
11111111111111111111111111111111
